    ###
   #   #
  #     #
 #       #
#         #
#   P     #
#         #
 #       #
  #     #
   #   #
    ###